50
111111111111111111111111111111
100000001070100000000100030001
100000001000100000000100030701
100040003000100001000100030001
100000003000100001000300030701
100050001000100001000300030001
100000001000300001000111111331
100060001000300001000000000001
100000001000100001000000000001
100000001000100001111111113311
111000111000100000000000000001
100000000000100000000000000001
100000000000100000000000000001
111001221111100000111111000001
100000000000000000111111000001
100000000000000000111111000001
100000000000000000111111000001
100000000000000000111111000001
111111110011100000111111000001
100000000000300000111111700001
107000000000300000111111000001
100110011000100000111111000001
100100001000100000111111000001
100200002000000000111111000001
100200702000000000111111000001
100100001000100000111111008001
100112211000100000111111000001
100000000000100000111111070701
100000000000100000111111000001
111111111111111111111111111111
